name Very Small Labyrinth of Dooom
win 2
##########################################
#......G....G$..............G............#
#............$..............G............#
#.G.......G..$..G..........E.....$.......#
#.....G...$$$$$$$$..............$G$......#
#..........E....................$.$......#
#..............$......G...........$......#
#...$$$...G.....$$..$$$$$$$..............#
#....$..........$.....G..................#
#...G..........$$.....G............G.....#
##########################################